{
    "name": "sortation_33_57_105-chutes",
    "weight": false,
    "n_row": 33,
    "n_col": 57,
    "n_endpoint": 517,
    "n_agent_loc": 0,
    "maxtime": 1000,
    "layout": [
        "TTTT.....w.....w.....w.....w.....w.....w.....w.....w.TTTT",
        "TTTT.................................................TTTT",
        "TTTT.................................................TTTT",
        "TTTT.................................................TTTT",
        ".........................................................",
        "w.....e..e..e..e..e..e..e..e..e..e..e..e..e..e..e........",
        ".....e@ee@ee@ee@ee@ee@ee@ee@ee@ee@ee@ee@ee@ee@ee@e.......",
        "......e..e..e..e..e..e..e..e..e..e..e..e..e..e..e........",
        "......e..e..e..e..e..e..e..e..e..e..e..e..e..e..e........",
        ".....e@ee@ee@ee@ee@ee@ee@ee@ee@ee@ee@ee@ee@ee@ee@e......w",
        "......e..e..e..e..e..e..e..e..e..e..e..e..e..e..e........",
        "w.....e..e..e..e..e..e..e..e..e..e..e..e..e..e..e........",
        ".....e@ee@ee@ee@ee@ee@ee@ee@ee@ee@ee@ee@ee@ee@ee@e.......",
        "......e..e..e..e..e..e..e..e..e..e..e..e..e..e..e........",
        "......e..e..e..e..e..e..e..e..e..e..e..e..e..e..e........",
        ".....e@ee@ee@ee@ee@ee@ee@ee@ee@ee@ee@ee@ee@ee@ee@e......w",
        "......e..e..e..e..e..e..e..e..e..e..e..e..e..e..e........",
        "w.....e..e..e..e..e..e..e..e..e..e..e..e..e..e..e........",
        ".....e@ee@ee@ee@ee@ee@ee@ee@ee@ee@ee@ee@ee@ee@ee@e.......",
        "......e..e..e..e..e..e..e..e..e..e..e..e..e..e..e........",
        "......e..e..e..e..e..e..e..e..e..e..e..e..e..e..e........",
        ".....e@ee@ee@ee@ee@ee@ee@ee@ee@ee@ee@ee@ee@ee@ee@e......w",
        "......e..e..e..e..e..e..e..e..e..e..e..e..e..e..e........",
        "w.....e..e..e..e..e..e..e..e..e..e..e..e..e..e..e........",
        ".....e@ee@ee@ee@ee@ee@ee@ee@ee@ee@ee@ee@ee@ee@ee@e.......",
        "......e..e..e..e..e..e..e..e..e..e..e..e..e..e..e........",
        ".........................................................",
        "........................................................w",
        ".........................................................",
        "TTTT.................................................TTTT",
        "TTTT.................................................TTTT",
        "TTTT.................................................TTTT",
        "TTTT.w.....w.....w.....w.....w.....w.....w.....w.....TTTT"
    ]
}